P ███████████████████
█   █   █           █
█ █ █ █ █ █ ███ █ █ █
█ █   █ █ █ █   █ █ █
███ █████ ███ ███████
█ █ █       █     █ █
█ █ ███████ █ █████ █
█   █       █       █
█ █ █████ █████ ███ █
█ █         █ █   █ █
█ █████ ███ █ ███████
█   █ █   █       █ █
███ █ █ ███████ █ █ █
█   █ █     █   █   █
█ ███ █ █ █ █ █ █ ███
█ █     █ █ █ █ █ █ █
█ ███ █████ ███████ █
█   █ █             █
█ █████████ ███████ █
█       █         █ █
███████████████████G█
