P ███████████████████████
█     █       █ █       █
█ █ ███ █ █ ███ █ █████ █
█ █     █ █ █         █ █
███████ █ █████ ███ █████
█ █     █   █   █       █
█ █ █ █████ █████ ███ ███
█   █ █         █   █   █
█ ███ ███ ███████ █ █ ███
█   █ █ █   █     █ █   █
███ █ █ ███ ███ █████████
█ █ █ █       █ █     █ █
█ █████████ █ █ ███ █ █ █
█   █   █ █ █       █   █
█ ███ ███ █████ █████ ███
█ █     █   █   █   █ █ █
█ █ █ █ █ █████████ █ █ █
█   █ █ █       █       █
███ ███████ ███ ███ █████
█           █   █ █ █   █
█ ███████ █████ █ █ ███ █
█ █       █   █   █     █
███ █████ █ █████ █ █████
█     █       █         G
█████████████████████████
