P ███████████████████████████
█     █ █           █     █ █
█ █ ███ █████ █ █ ███ ███ █ █
█ █ █   █     █ █   █ █     █
█ █████ ███████ ███ ███████ █
█         █ █   █         █ █
█ █████ ███ ███ █ █████████ █
█     █   █     █   █   █   █
█████ █ █████████ █ ███ █ ███
█ █ █ █ █         █     █   █
█ █ █ ███ █ █████████ ███ ███
█       █ █ █ █   █   █   █ █
███ █ █ ███ █ █ ███ █ █ █ █ █
█   █ █         █   █ █ █   █
█████ █ █████████ █████ █████
█     █       █           █ █
███ █████████ ███ █████ ███ █
█ █       █     █ █   █ █   █
█ ███ █ ███████ █ ███ ███ ███
█   █ █ █ █   █ █       █   █
█ █ █████ █ ███ █ █ █ █████ █
█ █             █ █ █ █   █ █
█ ███ ███████████████ ███ █ █
█ █         █   █           █
█ ███ ███ █████ █ ███ ███ █ █
█ █   █   █ █   █ █   █   █ █
█ █ ███████ ███ ███ █ ███ ███
█ █           █     █ █     G
█████████████████████████████
