P █████████████████████████████
█   █ █ █   █   █ █           █
█ ███ █ █ ███ ███ ███ ███████ █
█               █           █ █
█ ███ █ ███ █ █ █ ███ █ █████ █
█ █ █ █ █   █ █     █ █   █   █
█ █ █ ███████ ███████ ███ █ ███
█   █   █ █   █   █     █ █   █
███ █ █ █ ███████ ███████ ███ █
█   █ █   █ █ █ █             █
███ █ ███ █ █ █ ███ █████ █████
█       █     █ █       █   █ █
███ ███████████ ███ █ ███ █ █ █
█       █   █   █   █ █   █   █
█ █████ ███ █ █████ ███ ███ ███
█ █ █         █   █ █     █   █
███ █ █ █████████ █ ███ █ █████
█     █           █ █ █ █   █ █
█ ███ ███ ███ █████ █   █ █ █ █
█ █     █   █ █     █ █   █   █
█████ ███████ █████ █ ███████ █
█   █ █       █ █   █ █     █ █
█ ███ █ ███ █ █ ███ █ █ ██ ████
█     █ █   █           █   █ █
█ ███ ███ ███ █ █████ █ ███ █ █
█ █   █ █ █   █   █ █ █   █ █ █
█ █████ ███ █ █████ █████ █ █ █
█       █   █   █             █
█ █████ █ ███ █ █ █ ███ ███ ███
█ █           █   █   █ █     G
███████████████████████████████
