█P█████████████████████████████
█     █ █         █ █         █
█ █ ███ ███████ ███ █ ███████ █
█ █   █           █ █   █ █   █
█ █ ███ █████ █ ███ ███ █ ███ █
█ █     █   █ █       █     █ █
███ █ ███ █ █ ███ █████████ ███
█ █ █ █   █     █       █   █ █
█ █████████ ███ █ ███ ███ ███ █
█ █       █   █ █   █         █
█ █ █ ███ █████ █████ ███ █████
█   █ █       █     █   █ █ █ █
█ █ ███ █ ███████ ███ ███ █ █ █
█ █ █ █ █       █ █ █   █     █
███ █ ███ ███ █ ███ █████ ███ █
█   █ █ █ █   █             █ █
███ █ █ █████ ███ █████ █ ███ █
█ █ █       █ █ █     █ █ █   █
█ █████ ███████ █ █ █ █ ███ ███
█ █     █ █   █   █ █ █   █   █
█ █████ █ ███ █ █ █ █████ █████
█   █   █     █ █ █     █ █ █ █
█ ███ █████ █ █ ███ █ █████ █ █
█ █ █     █ █   █   █   █ █   █
█ █ ███ █ █ ███ ███ ███ █ █ █ █
█ █   █ █   █ █   █ █ █ █   █ █
█ █ ███ █ ███ ███████ █ █ █████
█ █     █     █       █ █     █
█ █ ███ █████ ███ █████ █████ █
█     █     █ █               G
███████████████████████████████
