P████████████████████
  █ █   █           █
█ █ ███ █████ ███ ███
█       █       █   █
███ █ ███████ ███████
█   █ █   █   █     █
█ █████ ███ ███████ █
█   █   █ █ █       █
█ █████ █ █ █ █████ █
█   █ █   █   █ █ █ █
█ ███ ███ █ █ █ █ ███
█     █ █   █ █     █
█████ █ █ █ █ ███ █ █
█   █ █   █ █     █ █
█ ███ █ █████ █ ███ █
█ █       █   █ █ █ █
█ ███ █ █ ███ █ █ ███
█   █ █ █   █ █ █   █
█ █ █ ███████ █████ █
█ █   █             █
█████████████████████
