P █████████████████████████████
█   █       █ █   █           █
█ ███ █ █ █ █ █ ███ ███████ ███
█     █ █ █ █ █   █ █     █   █
█ ███ ███ ███ █████ █ █ ███ ███
█     █   █ █       █ █ █ █   █
█████ █ █ █ ███ █████ █ █ ███ █
█       █       █   █ █ █     █
█ ███ █ █ ████████████ ███ ██ █
█     █   █     █    G      █ █
█ █ █ ███ █████ █ ███ ███████ █
█ █ █   █ █     █ █ █ █       █
█ █ █ ███ ███ █ ███ █ █ ███ ███
█ █ █ █ █     █     █   █ █   █
█ ███ █ ███████ ███████ ███ ███
█ █   █       █       █   █ █ █
█ █ █ █ █████ █ █████ ███ ███ █
█ █ █ █ █   █ █     █ █ █     █
█ █ █ █ █ █ █ ███ █ █ █ ███ ███
█     █ █ █       █ █   █ █   █
███ █████ ███ █████ █ █ █ █ ███
█       █ █ █ █     █ █ █   █ █
█ ███ ███ █ █ █ █████ █ █ ███ █
█   █ █ █   █   █   █ █       █
█ ███   █████ █ █ █ █ █████ █ █
█ █ █ █       █ █ █         █ █
█ █ █ ███ █████ █ █████ █████ █
█ █   █ █     █ █     █   █   █
█ ███ █ ███ █████ ███ ███ ███ █
█ █   █ █ █       █ █         █
█ ███ ███ ███ █████ █████████ █
███████████████████████████████