P ███████████████████████
█     █    G    █       █
█ █ ███ █ █ ███ █ █████ █
█ █     █ █ █         █ █
█ █████ █ █████ ███ █████
█ █     █   █   █       █
█ █ █ █████ █████ ███ ███
█   █ █         █   █   █
█ ███ ███ ███████ █ █ ███
█   █   █   █     █ █   █
███ █ █ ███ ███ █████████
█ █   █       █ █     █ █
█ █████████ █ █ ███ █ █ █
█   █   █ █ █       █   █
█ ███ ███ █████ █████ ███
█ █     █   █   █   █ █ █
█ █ █ █ █ █████████ █ █ █
█   █ █ █       █       █
███ ███████ ███ ███ █████
█           █   █ █ █   █
█ ███████ █████ █ █ ███ █
█ █       █   █   █     █
███ █████ █ █████ █ █████
█     █       █         █
█████████████████████████